########################
###..@...............###
###........#.........###
###........#.........###
###........#.........###
###........#.........###
###..................###
########################