########################
###..................###
###........#.........###
###........#.........###
###........#.........###
###........#.........###
###..................###
########################